##############################
##############################
##############################
##############################
##############################
##############################
##############################
##############################
##############################
##############################
##############################
##########.S....E....#########
##########S.SSSSSSSSS#########
##########..S........#########
###########.##################
##########SS.S...S...#########
##########...S.S.S.P.#########
##########.S...S.....#########
##############################
##############################
##############################
##############################
##############################
##############################
##############################
##############################
##############################
##############################
##############################
##############################