##############################
##############################
##############################
##############################
##############################
##############################
##############################
##############################
##############################
##############################
##############################
##########.S..S......#########
##########S.S.SSSSS.E#########
##########.S##################
##########..##################
##########.SSS...S...#########
##########S.S..SSS.P.#########
##########.S....SS...#########
##############################
##############################
##############################
##############################
##############################
##############################
##############################
##############################
##############################
##############################
##############################
##############################