##############################
##############################
##############################
##############################
##############################
##############################
##############################
##############################
##############################
##########....I###############
########I#.###I###############
########I..#.#I###############
########I###I#I###############
########I###I#I###############
########IIIII#I###############
########I.SSI#I###############
######IIIS.SI#I###############
#######...####I###############
######P.###......##...########
###########S.###.##SS.########
###########III$.......########
###########I##I###############
###########I##I###############
###########IIII###############
############.#################
############.#################
############E#################
##############################
##############################
##############################
