##############################
##############################
##############################
##############################
##############################
##############################
##############################
##############################
##############################
##############################
##############################
##############################
#############..E..############
#############SS.SS############
#############.SSS.############
#############S...S############
#############.SSS.############
#############.....############
#############.....############
#############.....############
#############..P..############
##############################
##############################
##############################
##############################
##############################
##############################
##############################
##############################
##############################