##############################
##############################
##############################
##############################
##############################
####################...#######
#################.S.....######
#################.###.S.######
#################.....S.######
#################.S###S#######
#################.S..#..######
#################..S.S.SE#####
##################.#.SS.######
####################S.########
###SS.....S...SPSSS...S#######
###SSS.SSSS...SS#####.########
######..S#####.S.......S######
#######S.###.S..##############
######.....#.S.###############
#####S..SSS.S.################
#######....###################
##############################
##############################
##############################
##############################
##############################
##############################
##############################
##############################
##############################