##############################
##############################
##############################
##############################
##############################
#######P######################
#######.######################
#######IIIIIIII$IIII$II#######
#######IIIII....IIIIIII#######
#######IIIIIIIIIIIIIII$#######
#######IIIIIII$IIIIIIII#######
#######IIIIIIIIIIIIIIII.E#####
#######IIIIIIIIIIIIIIII#######
#######$IIIIIIIIIIIIIII#######
#######IIIIIIIII$IIIIII#######
#######IIIIII$IIIIII$II#######
##############################
##############################
##############################
##############################
##############################
##############################
##############################
##############################
##############################
##############################
##############################
##############################
##############################
##############################
