##############################
##############################
##############################
##############################
##############################
##############################
#########I####################
#########I.....###############
#########I####.###############
########III###.###############
########I$I###.###############
########I$I###.###############
########.S..##.###############
######P..SS.#......###########
########....#...#S.###########
#############..IIII###########
#############..I##############
###############I##############
###############I..E###########
###############I##############
##############################
##############################
##############################
##############################
##############################
##############################
##############################
##############################
##############################
##############################
