##############################
##############################
##############################
##############################
##############################
##############################
###############E##############
###############.##############
#####..$III$IIIIIIIIIIIIIII###
#####..IIIIIIIIII$III$IIIII###
#####..IIIIII$IIIIIIIII$III###
#####..IIIIIIIIIII$I$IIIIII###
#####P.IIIII$IIIIIIIIIIIIII###
#####..IIIIIIIIIIIIII$IIIII###
#####..IIIIIII$IIIIIIIIIII$###
#####..$IIIIIIIIIIIII$$IIII###
##############################
##############################
##############################
##############################
##############################
##############################
##############################
##############################
##############################
##############################
##############################
##############################
##############################
##############################
