##############################
##############################
##############################
##############################
#...##########################
#.##.#########################
#.##.#########################
#....#########################
#.###.#.#...#.#.##.##.###.####
#.####.###.##.#.#.#.#..##.####
#.####.###.##...#.#.#.#.#.####
#.####.###.##.#.#.#.#.##..####
#.####.###.##.#.##.##.###.####
##############################
#%IIIIIIIIIIIIIIIIIIIIIIII&###
##############################
##############.########.######
#############.#.######.#.#####
############.###.####.###.####
###########.#####.##.#####.###
##############################
##############################
##############################
##############################
##############################
##############################
##############################
##############################
##############################
##############################
